672 28 24 42 48
04  04  04  04  04  04  04  04  04  04  04  04  04  04  04  04  04  04  04  04  04  04  04  04  04  04  04  04
  04  02  02  02  02  02  02  02  02  02  02  02  02  02  02  02  02  02  02  02  02  02  02  02  02  02  02  04
04  02  00  02  01  02  02  02  02  02  02  02  02  02  02  02  02  02  02  02  02  02  02  02  02  02  02  04
  04  02  02  02  02  02  02  02  02  02  02  02  02  02  02  02  02  02  02  02  02  02  02  02  02  02  02  04
04  02  02  02  02  02  02  02  02  02  02  02  02  02  02  02  02  02  02  02  02  02  02  02  02  02  02  04
  04  02  02  02  02  02  02  02  02  02  02  02  02  02  02  02  02  02  02  02  02  02  02  02  02  02  02  04
04  02  02  02  02  02  02  02  02  02  02  02  02  02  02  02  02  02  02  02  02  02  02  02  02  02  02  04
  04  02  02  02  02  02  02  02  02  02  02  02  02  02  02  02  02  02  02  02  02  02  02  02  02  02  02  04
04  02  02  02  02  04  04  02  04  04  04  04  04  04  04  04  04  04  04  04  04  04  04  02  02  02  02  04
  04  02  02  02  04  02  02  02  02  02  02  02  02  02  02  02  02  02  02  02  02  04  02  02  02  02  02  04
04  02  02  02  02  04  02  02  02  02  02  02  02  02  02  02  02  02  02  02  02  02  04  02  02  02  02  04
  04  02  02  02  04  02  02  04  04  04  04  04  04  04  04  04  04  04  04  02  02  04  02  02  02  02  02  04
04  02  02  02  02  04  02  02  04  02  02  02  02  02  02  02  02  02  02  04  02  02  04  02  02  02  02  04
  04  02  02  02  04  02  02  04  02  02  02  02  02  02  02  02  02  02  04  02  02  04  02  02  02  02  02  04
04  02  02  02  02  04  02  02  04  04  04  04  04  04  04  02  04  04  04  04  02  02  04  02  02  02  02  04
  04  02  02  02  04  02  02  02  02  02  02  02  02  02  02  02  02  02  02  02  02  04  02  02  02  02  02  04
04  02  02  02  02  04  02  02  02  02  02  02  02  02  02  02  02  02  02  02  02  02  04  02  02  02  02  04
  04  02  02  02  04  04  04  04  04  04  04  04  04  04  04  04  04  04  04  04  04  04  02  02  02  02  02  04
04  02  02  02  02  02  02  02  02  02  02  02  02  02  02  02  02  02  02  02  02  02  02  02  02  02  02  04
  04  02  02  02  02  02  02  02  02  02  02  02  02  02  02  02  02  02  02  02  02  02  02  02  02  02  02  04
04  02  02  02  02  02  02  02  02  02  02  02  02  02  02  02  02  02  02  02  02  02  02  02  02  02  02  04
  04  02  02  02  02  02  02  02  02  02  02  02  02  02  02  02  02  02  02  02  02  02  02  02  02  02  02  04
04  02  02  02  02  02  02  02  02  02  02  02  02  02  02  02  02  02  02  02  02  02  02  02  02  02  02  04
  04  04  04  04  04  04  04  04  04  04  04  04  04  04  04  04  04  04  04  04  04  04  04  04  04  04  04  04
