1152 1152 432
03 08 08 08 08 08 08 08 08 08 08 03 03 08 08 08 08 08 08 08 08 08 08 03 
06 01 01 01 01 01 01 01 01 01 01 10 06 01 01 01 01 01 01 01 01 01 01 10 
06 01 01 01 01 01 01 01 01 01 01 09 07 01 01 01 01 01 01 01 01 01 01 10 
06 01 01 01 01 01 01 01 01 01 01 01 01 01 01 01 01 01 11 04 05 01 01 10 
06 01 01 01 01 01 01 01 01 01 01 01 01 01 01 01 01 11 03 08 07 01 01 10 
06 01 01 01 01 01 01 01 01 01 01 11 05 01 01 01 11 03 08 01 01 01 01 10 
06 01 01 11 04 04 04 04 04 04 04 03 06 01 01 11 03 08 01 01 01 01 01 10 
06 01 01 10 03 08 08 08 08 08 08 03 06 01 01 09 08 01 01 01 01 01 01 10 
06 01 01 10 06 01 01 01 01 01 01 10 06 01 01 01 01 01 01 01 01 01 01 10 
06 01 01 10 06 01 01 01 01 01 01 10 06 01 01 01 01 01 01 01 01 01 01 10 
06 01 01 10 06 01 01 11 05 01 01 10 06 01 01 11 04 04 05 01 01 11 04 03 
06 01 01 10 06 01 01 10 06 01 01 10 06 01 01 10 03 08 07 01 01 10 03 03 
06 01 01 10 06 01 01 10 06 01 01 10 06 01 01 10 06 01 01 01 01 01 01 10 
06 01 01 10 03 04 04 03 06 01 01 10 06 01 01 10 06 01 01 01 01 01 01 10 
06 01 01 09 08 08 08 08 07 01 01 10 06 01 01 10 06 01 01 01 01 01 01 10 
06 01 01 01 01 01 01 01 01 01 01 10 06 01 01 10 06 01 01 01 01 01 01 10 
06 01 01 01 01 01 01 01 01 01 01 10 06 01 01 10 06 01 01 01 01 01 01 10 
03 04 04 04 04 04 04 04 04 04 04 03 03 04 04 03 03 04 04 04 04 04 04 03
