672 28 24 42 48
04  04  04  04  04  04  04  04  04  04  04  04  04  04  04  04  04  04  04  04  04  04  04  04  04  04  04  04
  04  01  01  01  01  01  01  01  01  01  01  01  01  01  01  01  01  04  02  02  02  02  02  02  02  02  02  04
04  01  01  01  01  01  01  01  01  01  01  01  01  01  01  01  01  04  02  02  02  02  02  02  02  02  02  04
  04  01  01  01  01  01  01  01  01  01  01  01  01  01  01  01  04  02  02  02  02  02  02  02  02  02  02  04
04  01  01  01  01  01  01  01  01  01  01  01  01  01  01  01  04  02  02  02  02  02  02  02  02  02  02  04
  04  01  01  01  01  01  01  01  01  01  01  01  01  01  01  04  02  02  02  02  02  02  02  02  02  02  02  04
04  01  01  01  01  01  01  01  01  01  01  01  01  01  01  04  01  01  01  01  01  01  01  01  01  01  01  04
  04  01  01  01  01  01  01  01  01  01  01  01  01  01  04  01  01  01  01  01  01  01  01  01  01  01  01  04
04  01  01  01  01  01  01  01  01  01  01  01  01  01  04  01  01  01  01  01  01  01  01  01  01  01  01  04
  04  01  01  01  01  01  01  01  01  01  01  01  01  04  01  01  01  01  01  01  01  01  01  01  01  01  01  04
04  01  01  01  01  01  01  01  01  01  01  01  01  01  01  01  01  01  01  01  01  01  01  01  01  01  01  04
  04  01  01  01  01  01  01  01  01  01  01  01  01  01  01  01  01  01  01  01  01  01  01  01  01  01  01  04
04  01  01  01  01  01  01  01  01  01  01  01  01  01  01  01  01  01  01  01  01  01  01  01  01  01  01  04
  04  01  01  01  01  01  01  01  01  01  01  01  01  01  01  01  01  01  01  01  01  01  01  01  01  01  01  04
04  01  01  01  01  01  01  01  01  01  01  01  01  01  01  01  01  01  01  01  01  01  01  01  01  01  01  04
  04  01  01  01  01  01  01  01  01  01  01  01  01  04  01  01  01  01  01  01  01  01  01  01  01  01  01  04
04  01  01  01  01  01  01  01  01  01  01  01  01  01  04  01  01  01  01  01  01  01  01  01  01  01  01  04
  04  01  01  01  01  01  01  01  01  01  01  01  01  01  04  01  01  01  01  01  01  01  01  01  01  01  01  04
04  01  01  01  01  01  01  01  01  01  01  01  01  01  01  04  01  01  01  01  01  01  01  01  01  01  01  04
  04  01  01  01  01  01  01  01  01  01  01  01  01  01  01  04  01  01  01  01  01  01  01  01  01  01  01  04
04  01  01  01  01  01  01  01  01  01  01  01  01  01  01  01  04  01  01  01  01  01  01  01  01  01  01  04
  04  01  01  01  01  01  01  01  01  01  01  01  01  01  01  01  04  01  01  01  01  01  01  01  01  01  01  04
04  01  01  01  01  01  01  01  01  01  01  01  01  01  01  01  01  04  01  01  01  01  01  01  01  01  01  04
  04  04  04  04  04  04  04  04  04  04  04  04  04  04  04  04  04  04  04  04  04  04  04  04  04  04  04  04
