6400 3600 3600
03 08 08 08 08 08 08 08 08 08 08 08 08 08 08 08 08 08 08 08 08 08 08 08 08 08 08 08 08 08 08 08 08 08 08 08 08 08 08 08 08 08 08 08 08 08 08 08 08 08 08 08 08 08 08 08 08 08 08 08 08 08 08 08 08 08 08 08 08 08 08 08 08 08 08 08 08 08 08 03
06 02 02 02 02 02 02 02 02 02 02 02 02 02 02 02 02 02 02 02 02 02 02 02 02 02 02 02 02 02 02 02 02 02 02 02 02 02 02 02 02 02 02 02 02 02 02 02 02 02 02 02 02 02 02 02 02 02 02 02 02 02 02 02 02 02 02 02 02 02 02 02 02 02 02 02 02 02 02 10
06 02 02 02 02 02 02 02 02 02 02 02 02 02 02 02 02 02 02 02 02 02 02 02 02 02 02 02 02 02 02 02 02 02 02 02 02 02 02 02 02 02 02 02 02 02 02 02 02 02 02 02 02 02 02 02 02 02 02 02 02 02 02 02 02 02 02 02 02 02 02 02 02 02 02 02 02 02 02 10
06 02 02 11 04 04 04 04 04 04 04 04 04 04 04 04 04 04 04 04 04 04 04 04 04 04 04 04 04 04 04 04 04 04 04 04 04 04 04 04 04 04 04 04 04 04 04 04 04 04 04 04 04 04 04 04 04 04 04 04 04 04 04 04 04 04 04 04 04 04 04 04 04 04 04 04 05 02 02 10
06 02 02 10 03 03 03 03 03 03 03 03 03 03 03 03 03 03 03 03 03 03 03 03 03 03 03 03 03 03 03 03 03 03 03 03 03 03 03 03 03 03 03 03 03 03 03 03 03 03 03 03 03 03 03 03 03 03 03 03 03 03 03 03 03 03 03 03 03 03 03 03 03 03 03 03 06 02 02 10
06 02 02 10 03 03 08 08 08 08 08 08 08 08 08 08 08 08 08 08 08 08 08 08 08 08 08 08 08 08 08 08 08 08 08 08 08 08 08 08 08 08 08 08 08 08 08 08 08 08 08 08 08 08 08 08 08 08 08 08 08 08 08 08 08 08 08 08 08 08 08 08 08 08 08 08 07 02 02 10
06 02 02 10 03 06 02 02 02 02 02 02 02 02 02 02 02 02 02 02 02 02 02 02 02 02 02 02 02 02 02 02 02 02 02 02 02 02 02 02 02 02 02 02 02 02 02 02 02 02 02 02 02 02 02 02 02 02 02 02 02 02 02 02 02 02 02 02 02 02 02 02 02 02 02 02 02 02 02 10
06 02 02 10 03 06 02 02 02 02 02 02 02 02 02 02 02 02 02 02 02 02 02 02 02 02 02 02 02 02 02 02 02 02 02 02 02 02 02 02 02 02 02 02 02 02 02 02 02 02 02 02 02 02 02 02 02 02 02 02 02 02 02 02 02 02 02 02 02 02 02 02 02 02 02 02 02 02 02 10
06 02 02 10 03 06 02 02 11 04 04 04 04 04 04 04 04 04 04 04 04 04 04 04 04 04 04 04 04 04 04 04 04 04 04 04 04 04 04 04 05 02 02 11 04 04 04 04 04 04 04 04 04 04 04 04 04 04 04 04 04 04 04 04 04 04 04 04 04 04 04 05 02 02 11 04 05 02 02 10
06 02 02 10 03 06 02 02 10 03 03 03 03 03 03 03 03 03 03 03 03 03 03 03 03 03 03 03 03 03 03 03 03 03 03 03 03 03 03 03 06 02 02 10 03 03 03 03 03 03 03 03 03 03 03 03 03 03 03 03 03 03 03 03 03 03 03 03 03 03 03 06 02 02 10 03 06 02 02 10
06 02 02 10 03 06 02 02 09 08 08 08 08 03 03 03 08 08 08 08 08 08 08 03 03 03 08 08 08 08 08 08 08 03 03 03 08 08 08 08 07 02 02 09 08 08 08 08 08 08 08 08 08 03 03 03 08 08 08 08 08 08 08 03 03 03 08 08 08 03 03 06 02 02 10 03 06 02 02 10
06 02 02 10 03 06 02 02 02 02 02 02 02 10 03 06 02 02 02 02 02 02 02 10 03 06 02 02 02 02 02 02 02 10 03 06 02 02 02 02 02 02 02 02 02 02 02 02 02 02 02 02 02 10 03 06 02 02 02 02 02 02 02 10 03 06 02 02 02 10 03 06 02 02 10 03 06 02 02 10
06 02 02 10 03 06 02 02 02 02 02 02 02 10 03 06 02 02 02 02 02 02 02 10 03 06 02 02 02 02 02 02 02 10 03 06 02 02 02 02 02 02 02 02 02 02 02 02 02 02 02 02 02 10 03 06 02 02 02 02 02 02 02 10 03 06 02 02 02 10 03 06 02 02 10 03 06 02 02 10
06 02 02 10 03 06 02 02 11 04 05 02 02 10 03 06 02 02 11 04 05 02 02 10 03 06 02 02 11 04 05 02 02 10 03 06 02 02 02 02 02 02 02 02 02 02 02 02 11 04 05 02 02 10 03 06 02 02 11 04 05 02 02 10 03 06 02 02 02 10 03 06 02 02 10 03 06 02 02 10
06 02 02 10 03 06 02 02 10 03 06 02 02 10 03 06 02 02 10 03 06 02 02 10 03 06 02 02 10 03 06 02 02 10 03 06 02 02 02 02 02 02 02 02 02 02 02 02 10 03 06 02 02 10 03 06 02 02 10 03 06 02 02 10 03 06 02 02 02 10 03 06 02 02 10 03 06 02 02 10
06 02 02 10 03 06 02 02 10 03 06 02 02 10 03 06 02 02 10 03 06 02 02 10 03 06 02 02 10 03 06 02 02 10 03 06 02 02 02 02 02 02 02 02 02 02 02 02 10 03 06 02 02 10 03 06 02 02 10 03 06 02 02 10 03 06 02 02 02 10 03 06 02 02 10 03 06 02 02 10
06 02 02 10 03 06 02 02 10 03 06 02 02 10 03 06 02 02 10 03 06 02 02 10 03 06 02 02 10 03 06 02 02 10 03 06 02 02 02 02 02 02 02 02 02 02 02 02 10 03 06 02 02 10 03 06 02 02 10 03 06 02 02 10 03 06 02 02 02 10 03 06 02 02 10 03 06 02 02 10
06 02 02 10 03 06 02 02 10 03 06 02 02 10 03 06 02 02 10 03 06 02 02 10 03 06 02 02 10 03 06 02 02 10 03 06 02 02 02 02 02 02 02 02 02 02 02 02 10 03 06 02 02 10 03 06 02 02 10 03 06 02 02 10 03 06 02 02 02 10 03 06 02 02 10 03 06 02 02 10
06 02 02 10 03 06 02 02 10 03 06 02 02 10 03 06 02 02 10 03 06 02 02 10 03 06 02 02 10 03 06 02 02 10 03 06 02 02 02 02 02 02 02 02 02 02 02 02 10 03 06 02 02 10 03 06 02 02 10 03 06 02 02 10 03 06 02 02 02 10 03 06 02 02 10 03 06 02 02 10
06 02 02 10 03 06 02 02 10 03 06 02 02 10 03 06 02 02 10 03 06 02 02 10 03 06 02 02 10 03 06 02 02 10 03 06 02 02 02 02 02 02 02 02 02 02 02 02 10 03 06 02 02 10 03 06 02 02 10 03 06 02 02 10 03 06 02 02 02 10 03 06 02 02 10 03 06 02 02 10
06 02 02 10 03 06 02 02 10 03 06 02 02 10 03 06 02 02 10 03 06 02 02 10 03 06 02 02 10 03 06 02 02 10 03 06 02 02 02 02 02 02 02 02 02 02 02 02 10 03 06 02 02 10 03 06 02 02 10 03 06 02 02 10 03 06 02 02 02 10 03 06 02 02 10 03 06 02 02 10
06 02 02 10 03 06 02 02 10 03 06 02 02 10 03 06 02 02 10 03 06 02 02 10 03 06 02 02 10 03 06 02 02 10 03 06 02 02 02 02 02 02 02 02 02 02 02 02 10 03 06 02 02 10 03 06 02 02 10 03 06 02 02 10 03 06 02 02 02 10 03 06 02 02 10 03 06 02 02 10
06 02 02 10 03 06 02 02 10 03 06 02 02 10 03 06 02 02 10 03 06 02 02 10 03 06 02 02 10 03 06 02 02 10 03 06 02 02 02 02 02 02 02 02 02 02 02 02 10 03 06 02 02 10 03 06 02 02 10 03 06 02 02 10 03 06 02 02 02 10 03 06 02 02 10 03 06 02 02 10
06 02 02 10 03 06 02 02 10 03 06 02 02 10 03 06 02 02 10 03 06 02 02 10 03 06 02 02 10 03 06 02 02 10 03 06 02 02 02 02 02 02 02 02 02 02 02 02 10 03 06 02 02 10 03 06 02 02 10 03 06 02 02 10 03 06 02 02 02 10 03 06 02 02 10 03 06 02 02 10
06 02 02 10 03 06 02 02 10 03 06 02 02 10 03 06 02 02 10 03 06 02 02 10 03 06 02 02 10 03 06 02 02 10 03 06 02 02 02 02 02 02 02 02 02 02 02 02 10 03 06 02 02 10 03 06 02 02 10 03 06 02 02 10 03 06 02 02 02 10 03 06 02 02 10 03 06 02 02 10
06 02 02 10 03 06 02 02 10 03 06 02 02 10 03 06 02 02 10 03 06 02 02 10 03 06 02 02 10 03 06 02 02 10 03 06 02 02 02 02 02 02 02 02 02 02 02 02 10 03 06 02 02 10 03 06 02 02 10 03 06 02 02 10 03 06 02 02 02 10 03 06 02 02 10 03 06 02 02 10
06 02 02 10 03 06 02 02 10 03 06 02 02 10 03 06 02 02 10 03 06 02 02 10 03 06 02 02 10 03 06 02 02 10 03 06 02 02 02 02 02 02 02 02 02 02 02 02 10 03 06 02 02 10 03 06 02 02 10 03 06 02 02 10 03 06 02 02 02 10 03 06 02 02 10 03 06 02 02 10
06 02 02 10 03 06 02 02 10 03 06 02 02 10 03 06 02 02 10 03 06 02 02 10 03 06 02 02 10 03 06 02 02 10 03 06 02 02 02 02 02 02 02 02 02 02 02 02 10 03 06 02 02 10 03 06 02 02 10 03 06 02 02 10 03 06 02 02 02 10 03 06 02 02 10 03 06 02 02 10
06 02 02 10 03 06 02 02 10 03 06 02 02 10 03 06 02 02 10 03 06 02 02 10 03 06 02 02 10 03 06 02 02 10 03 06 02 02 02 02 02 02 02 02 02 02 02 02 10 03 06 02 02 10 03 06 02 02 10 03 06 02 02 10 03 06 02 02 02 10 03 06 02 02 10 03 06 02 02 10
06 02 02 10 03 06 02 02 10 03 06 02 02 10 03 06 02 02 10 03 06 02 02 10 03 06 02 02 10 03 06 02 02 10 03 06 02 02 02 02 02 02 02 02 02 02 02 02 10 03 06 02 02 10 03 06 02 02 10 03 06 02 02 10 03 06 02 02 02 10 03 06 02 02 10 03 06 02 02 10
06 02 02 10 03 06 02 02 10 03 06 02 02 10 03 06 02 02 10 03 06 02 02 10 03 06 02 02 10 03 06 02 02 10 03 06 02 02 02 02 02 02 02 02 02 02 02 02 10 03 06 02 02 10 03 06 02 02 10 03 06 02 02 10 03 06 02 02 02 10 03 06 02 02 10 03 06 02 02 10
06 02 02 10 03 06 02 02 10 03 06 02 02 09 08 07 02 02 10 03 06 02 02 09 08 07 02 02 10 03 06 02 02 09 08 07 02 02 02 02 02 02 02 02 02 02 02 02 10 03 06 02 02 09 08 07 02 02 10 03 06 02 02 09 08 07 02 02 02 09 08 07 02 02 10 03 06 02 02 10
06 02 02 10 03 06 02 02 10 03 06 02 02 02 02 02 02 02 10 03 06 02 02 02 02 02 02 02 10 03 06 02 02 02 02 02 02 02 02 02 02 02 02 02 02 02 02 02 10 03 06 02 02 02 02 02 02 02 10 03 06 02 02 02 02 02 02 02 02 02 02 02 02 02 10 03 06 02 02 10
06 02 02 10 03 06 02 02 10 03 06 02 02 02 02 02 02 02 10 03 06 02 02 02 02 02 02 02 10 03 06 02 02 02 02 02 02 02 02 02 02 02 02 02 02 02 02 02 10 03 06 02 02 02 02 02 02 02 10 03 06 02 02 02 02 02 02 02 02 02 02 02 02 02 10 03 06 02 02 10
06 02 02 10 03 06 02 02 10 03 03 04 04 04 04 04 04 04 03 03 03 04 04 04 04 04 04 04 03 03 03 04 04 04 04 04 04 04 04 04 05 02 02 11 04 04 04 04 03 03 03 04 04 04 04 04 04 04 03 03 03 04 04 04 04 04 04 04 04 04 04 05 02 02 10 03 06 02 02 10
06 02 02 10 03 06 02 02 10 03 03 03 03 03 03 03 03 03 03 03 03 03 03 03 03 03 03 03 03 03 03 03 03 03 03 03 03 03 03 03 06 02 02 10 03 03 03 03 03 03 03 03 03 03 03 03 03 03 03 03 03 03 03 03 03 03 03 03 03 03 03 06 02 02 10 03 06 02 02 10
06 02 02 09 08 07 02 02 09 08 08 08 08 08 08 08 08 08 08 08 08 08 08 08 08 08 08 08 08 08 08 08 08 08 08 08 08 08 08 08 07 02 02 09 08 08 08 08 08 08 08 08 08 08 08 08 08 08 08 08 08 08 08 08 08 08 08 08 08 08 08 07 02 02 10 03 06 02 02 10
06 02 02 02 02 02 02 02 02 02 02 02 02 02 02 02 02 02 02 02 02 02 02 02 02 02 02 02 02 02 02 02 02 02 02 02 02 02 02 02 02 02 02 02 02 02 02 02 02 02 02 02 02 02 02 02 02 02 02 02 02 02 02 02 02 02 02 02 02 02 02 02 02 02 10 03 06 02 02 10
06 02 02 02 02 02 02 02 02 02 02 02 02 02 02 02 02 02 02 02 02 02 02 02 02 02 02 02 02 02 02 02 02 02 02 02 02 02 02 02 02 02 02 02 02 02 02 02 02 02 02 02 02 02 02 02 02 02 02 02 02 02 02 02 02 02 02 02 02 02 02 02 02 02 10 03 06 02 02 10
06 02 02 11 04 04 04 04 04 04 04 04 04 04 04 04 04 04 04 04 04 04 04 04 04 04 04 04 04 04 04 04 04 04 04 04 04 04 04 04 04 04 04 04 04 04 04 04 04 04 04 04 04 04 04 04 04 04 04 04 04 04 04 04 04 04 04 04 04 04 04 04 04 04 03 03 06 02 02 10
06 02 02 10 03 03 03 03 03 03 03 03 03 03 03 03 03 03 03 03 03 03 03 03 03 03 03 03 03 03 03 03 03 03 03 03 03 03 03 03 03 03 03 03 03 03 03 03 03 03 03 03 03 03 03 03 03 03 03 03 03 03 03 03 03 03 03 03 03 03 03 03 03 03 03 03 06 02 02 10
06 02 02 09 08 08 08 08 08 08 08 08 08 08 08 08 08 08 08 08 08 08 08 08 08 08 08 08 08 08 08 08 08 08 08 08 08 08 08 08 08 08 08 08 08 08 08 08 08 08 08 08 08 08 08 08 08 08 08 08 08 08 08 08 08 08 08 08 08 08 08 08 08 08 08 08 07 02 02 10
06 02 02 02 02 02 02 02 02 02 02 02 02 02 02 02 02 02 02 02 02 02 02 02 02 02 02 02 02 02 02 02 02 02 02 02 02 02 02 02 02 02 02 02 02 02 02 02 02 02 02 02 02 02 02 02 02 02 02 02 02 02 02 02 02 02 02 02 02 02 02 02 02 02 02 02 02 02 02 10
06 02 02 02 02 02 02 02 02 02 02 02 02 02 02 02 02 02 02 02 02 02 02 02 02 02 02 02 02 02 02 02 02 02 02 02 02 02 02 02 02 02 02 02 02 02 02 02 02 02 02 02 02 02 02 02 02 02 02 02 02 02 02 02 02 02 02 02 02 02 02 02 02 02 02 02 02 02 02 10
03 04 04 04 04 04 04 04 04 04 04 04 04 04 04 04 04 04 04 04 04 04 04 04 04 04 04 04 04 04 04 04 04 04 04 04 04 04 04 04 04 04 04 04 04 04 04 04 04 04 04 04 04 04 04 04 04 04 04 04 04 04 04 04 04 04 04 04 04 04 04 04 04 04 04 04 04 04 04 03
